{
	"start": [1, 1],
	"height": 9,
	"width": 8,
	"cells id's": [
		[4,4,4,4,4,4,4,4],
		[4,0,0,0,0,0,0,4],
		[4,0,0,0,0,0,0,4],
		[4,0,0,1,0,0,0,4],
		[4,0,0,0,4,0,0,4],
		[4,0,0,4,4,0,0,4],
		[4,0,0,0,0,0,0,4],
		[4,0,0,0,4,0,0,4],
		[4,4,4,4,4,4,4,4]
	]
}