{
	"start": [1, 1],
	"height": 5,
	"width": 9,
	"cells id's": [
		[5, 4, 4, 16, 4, 4, 4, 4, 6],
		[5, 0, 0, 4, 0, 0, 0, 0, 6],
		[5, 0, 0, 0, 0, 12, 0, 0, 6],
		[5, 0, 12, 0, 11, 17, 0, 1, 6],
		[9, 4, 19, 4, 8, 9, 4, 4, 8]
	]
}