{
	"old start": [26, 38],
	"start": [9, 22],
	"height": 40,
	"width": 33,
	"cells id's": [
		[2, 2, 2, 2, 5, 4, 4, 4,16, 4, 4, 4,16, 4, 4, 4,16, 4, 4, 4,16, 4, 4, 4,16, 4, 4, 4, 6, 2, 2, 2, 2],
		[2, 2, 2, 2, 5, 0, 0, 0, 4, 0, 0, 0,16, 0, 0, 0, 4, 0, 0, 0,16, 0, 0, 0, 4, 0, 0, 0, 6, 2, 2, 2, 2],
		[2, 2, 2, 2, 5, 0, 0, 0, 0, 0, 0, 0,16, 0, 0, 0, 0, 0, 0, 0,16, 0, 0, 0, 0, 0, 0, 0, 6, 2, 2, 2, 2],
		[2, 2, 2, 2, 5, 0, 0, 0,12, 0, 0, 0,16, 0, 0, 0,12, 0, 0, 0,16, 0, 0, 0,12, 0, 0, 0, 6, 2, 2, 2, 2],
		[2, 2, 2, 2, 9,10, 0,11,19,10, 0,11,19, 4, 4, 4,19, 4, 4, 4,19, 4, 4, 4,19,10, 0,11, 8, 2, 2, 2, 2],
		[5, 4, 4, 4,16, 4, 0, 4,16, 4, 0, 4,16, 4, 4, 4,16, 4, 4, 4,16, 4, 4, 4,16, 4, 0, 4,16, 4, 4, 4, 6],
		[5, 0, 0, 0,16, 0, 0, 0,16, 0, 0, 0, 4, 0, 0, 0,16, 0, 0, 0, 4, 0, 0, 0, 4, 0, 0, 0,16, 0, 0, 0, 6],
		[5, 0, 0, 0,16, 0, 0, 0,16, 0, 0, 0, 0, 0, 0, 0,16, 0, 0, 0, 0, 0, 0, 0, 0, 0, 0, 0,16, 0, 0, 0, 6],
		[5, 0, 0, 0,16, 0, 0, 0,16, 0, 0, 0,12, 0, 0, 0,16, 0, 0, 0,12, 0, 0, 0,12, 0, 0, 0,16, 0, 0, 0, 6],
		[9,10, 0,11,19,10, 0,11,19,10, 0,11,19,10, 0,11,19,10, 0,11,19,10, 0,11,19,10, 0,11,19,10, 0,11, 8],
		[5, 4, 0, 4,16, 4, 0, 4,16, 4, 0, 4,16, 4, 0, 4,16, 4, 0, 4,16, 4, 0, 4,16, 4, 0, 4,16, 4, 0, 4, 6],
		[5, 0, 0, 0,16, 0, 0, 0, 4, 0, 0, 0, 4, 0, 0, 0, 4, 0, 0, 0,16, 0, 0, 0, 4, 0, 0, 0, 4, 0, 0, 0, 6],
		[5, 0, 0, 0,16, 0, 0, 0, 0, 0, 0, 0, 0, 0, 0, 0, 0, 0, 0, 0,16, 0, 0, 0, 0, 0, 0, 0, 0, 0, 0, 0, 6],
		[5, 0, 0, 0,16, 0, 0, 0,12, 0, 0, 0,12, 0, 0, 0,12, 0, 0, 0,16, 0, 0, 0,12, 0, 0, 0,12, 0, 0, 0, 6],
		[9, 4, 4, 4,19,10, 0,11,19, 4, 4, 4,19,10, 0,11,19,10, 0,11,19, 4, 4, 4,19,10, 0,11,19,10, 0,11, 8],
		[5, 4, 4, 4,16, 4, 0, 4,16, 4, 4, 4,16, 4, 0, 4,16, 4, 0, 4, 6, 2, 2, 2, 5, 4, 0, 4,16, 4, 0, 4, 6],
		[5, 0, 0, 0, 4, 0, 0, 0,16, 0, 0, 0,16, 0, 0, 0, 4, 0, 0, 0, 6, 2, 2, 2, 5, 0, 0, 0, 4, 0, 0, 0, 6],
		[5, 0, 0, 0, 0, 0, 0, 0,16, 0, 1, 0,16, 0, 0, 0, 0, 0, 0, 0, 6, 2, 2, 2, 5, 0, 0, 0, 0, 0, 0, 0, 6],
		[5, 0, 0, 0,12, 0, 0, 0,16, 0, 0, 0,16, 0, 0, 0,12, 0, 0, 0, 6, 2, 2, 2, 5, 0, 0, 0,12, 0, 0, 0, 6],
		[9,10, 0,11,19,10, 0,11,19,10, 0,11,19, 4, 4, 4,19,10, 0,11, 8, 2, 2, 2, 9, 4, 4, 4,19,10, 0,11, 8],
		[5, 4, 0, 4,16, 4, 0, 4,16, 4, 0, 4,16, 4, 4, 4,16, 4, 0, 4,16, 4, 4, 4,16, 4, 4, 4,16, 4, 0, 4, 6],
		[5, 0, 0, 0,16, 0, 0, 0,16, 0, 0, 0,16, 0, 0, 0,16, 0, 0, 0, 4, 0, 0, 0, 4, 0, 0, 0,16, 0, 0, 0, 6],
		[5, 0, 0, 0,16, 0, 0, 0,16, 0, 0, 0,16, 0, 0, 0,16, 0, 0, 0, 0, 0, 0, 0, 0, 0, 0, 0,16, 0, 0, 0, 6],
		[5, 0, 0, 0,16, 0, 0, 0,16, 0, 0, 0,16, 0, 0, 0,16, 0, 0, 0,12, 0, 0, 0,12, 0, 0, 0,16, 0, 0, 0, 6],
		[9,10, 0,11,19,10, 0,11,19,10, 0,11,19,10, 0,11,19,10, 0,11,19,10, 0,11,19,10, 0,11,19,10, 0,11, 8],
		[5, 4, 0, 4,16, 4, 0, 4,16, 4, 0, 4,16, 4, 0, 4,16, 4, 0, 4,16, 4, 0, 4,16, 4, 0, 4,16, 4, 0, 4, 6],
		[5, 0, 0, 0, 4, 0, 0, 0,16, 0, 0, 0, 4, 0, 0, 0,16, 0, 0, 0, 4, 0, 0, 0, 4, 0, 0, 0,16, 0, 0, 0, 6],
		[5, 0, 0, 0, 0, 0, 0, 0,16, 0, 0, 0, 0, 0, 0, 0,16, 0, 0, 0, 0, 0, 0, 0, 0, 0, 0, 0,16, 0, 0, 0, 6],
		[5, 0, 0, 0,12, 0, 0, 0,16, 0, 0, 0,12, 0, 0, 0,16, 0, 0, 0,12, 0, 0, 0,12, 0, 0, 0,16, 0, 0, 0, 6],
		[9, 4, 4, 4,19,10, 0,11,19, 4, 4, 4,19,10, 0,11,19,10, 0,11,19,10, 0,11,19,10, 0,11,19, 4, 4, 4, 6],
		[2, 2, 2, 2, 5, 4, 0, 4,16, 4, 4, 4,16, 4, 0, 4,16, 4, 0, 4,16, 4, 0, 4,16, 4, 0, 4, 6, 2, 2, 2, 2],
		[2, 2, 2, 2, 5, 0, 0, 0, 4, 0, 0, 0, 4, 0, 0, 0,16, 0, 0, 0, 4, 0, 0, 0, 4, 0, 0, 0, 6, 2, 2, 2, 2],
		[2, 2, 2, 2, 5, 0, 0, 0, 0, 0, 0, 0, 0, 0, 0, 0,16, 0, 0, 0, 0, 0, 0, 0, 0, 0, 0, 0, 6, 2, 2, 2, 2],
		[2, 2, 2, 2, 5, 0, 0, 0,12, 0, 0, 0,12, 0, 0, 0,16, 0, 0, 0,12, 0, 0, 0,12, 0, 0, 0, 6, 2, 2, 2, 2],
		[2, 2, 2, 2, 9,10, 0,11,19, 4, 4, 4,19,10, 0,11,19, 4, 4, 4,19, 4, 4, 4,19,10, 0,11, 8, 2, 2, 2, 2],
		[2, 2, 2, 2, 5, 4, 0, 4, 6, 2 ,2, 2, 5, 4 ,0, 4,16, 4, 4, 4, 6, 2, 2, 2, 5, 4, 0, 4, 6, 2, 2, 2, 2],
		[2, 2, 2, 2, 5, 0, 0, 0, 6, 2, 2, 2, 5, 0, 0, 0, 4, 0, 0, 0, 6, 2, 2, 2, 5, 0, 0, 0, 6, 2, 2, 2, 2],
		[2, 2, 2, 2, 5, 0, 0, 0, 6, 2, 2, 2, 5, 0, 0, 0, 0, 0, 0, 0, 6, 2, 2, 2, 5, 0, 0, 0, 6, 2, 2, 2, 2],
		[2, 2, 2, 2, 5, 0, 0, 0, 6, 2, 2, 2, 5, 0, 0, 0,12, 0, 0, 0, 6, 2, 2, 2, 5, 0, 0, 0, 6, 2, 2, 2, 2],
		[2, 2, 2, 2, 9, 4, 4, 4, 8, 2, 2, 2, 9, 4, 4, 4,19, 4, 4, 4, 8, 2, 2, 2, 9, 4, 4, 4, 8, 2, 2, 2, 2]
	]
}